NO textures/no.xpm
SO textures/so.xpm
WE textures/we.xpm
EA textures/ea.xpm

F 0, 128, 0
C 0, 191, 255

1111 1111
1001 0001
100010001
100000001
1000Т0001
111111111