SO textures/no.xpm
NO textures/so.xpm
WE textures/we.xpm
EA textures/ea.xpm

F 0, 128, 64
C 64, 191, 255

1111 1111111
1001 10011111111111111111
10001000000011000100000001
10000000111000100000001
100101001110001000000011
100010000001000100000001
10000000111111111111111
1000W000001
11111111111