NO textures/no.xpm
SO textures/so.xpm
WE textures/we.xpm
EA textures/ea.xpm

F 0, 128, 0
C 0, 191, 255

1111111111111111111111111
1000000000000000000000001
1000000000000000000000001
1001111111111111111111001
1001000000000000000001001
1001000000000000000001001
1001001111111111111001001
1001001001001001001001001
1001001000000000000001001
1001001000000000000001001
1001001111111111111111001
1001000000000000000000001
1N01000000000000000000001
1111111111111111111111111
